//MAP CONVERTED BY dmm2tgm.py THIS HEADER COMMENT PREVENTS RECONVERSION, DO NOT REMOVE
"aw" = (
/obj/structure/chair/comfy/shuttle{
	dir = 1
	},
/obj/machinery/light/small,
/turf/open/floor/pod/dark,
/area/ruin/unpowered)
"dL" = (
/obj/machinery/light/broken{
	dir = 4
	},
/turf/open/floor/pod,
/area/ruin/unpowered)
"eD" = (
/turf/open/floor/pod/dark,
/area/ruin/unpowered)
"eK" = (
/obj/machinery/stasis{
	dir = 4
	},
/obj/machinery/light/broken{
	dir = 8
	},
/turf/open/floor/plating/lavaland_baseturf,
/area/ruin/unpowered)
"eS" = (
/obj/structure/door_assembly/door_assembly_hatch,
/turf/open/floor/pod,
/area/lavaland/surface/outdoors/explored)
"fG" = (
/turf/closed/wall/r_wall/syndicate,
/area/ruin/unpowered)
"gf" = (
/obj/item/ammo_box/n762,
/turf/open/floor/plating/asteroid/basalt/lava_land_surface,
/area/lavaland/surface/outdoors/explored)
"gn" = (
/obj/structure/lattice,
/obj/structure/table_frame,
/turf/open/floor/plating/asteroid/basalt/lava_land_surface,
/area/ruin/unpowered)
"gW" = (
/obj/structure/shuttle/engine/propulsion,
/turf/open/floor/plating/lavaland_baseturf,
/area/ruin/unpowered)
"hA" = (
/obj/structure/lattice,
/turf/open/floor/plating/asteroid/basalt/lava_land_surface,
/area/lavaland/surface/outdoors/explored)
"ic" = (
/turf/closed/wall/r_wall/syndicate/nodiagonal,
/area/lavaland/surface/outdoors/explored)
"io" = (
/obj/structure/table/reinforced,
/turf/open/floor/pod,
/area/ruin/unpowered)
"iB" = (
/obj/structure/lattice,
/turf/open/floor/plating/asteroid/basalt/lava_land_surface,
/area/ruin/unpowered)
"iR" = (
/turf/open/floor/pod,
/area/ruin/unpowered)
"kC" = (
/obj/machinery/computer,
/turf/open/floor/plating/lavaland_baseturf,
/area/ruin/unpowered)
"mo" = (
/obj/machinery/computer{
	dir = 8
	},
/turf/open/floor/pod/dark,
/area/ruin/unpowered)
"mG" = (
/obj/effect/decal/cleanable/blood/gibs/down,
/obj/machinery/light/small/broken,
/turf/open/floor/plating/lavaland_baseturf,
/area/ruin/unpowered)
"pa" = (
/obj/structure/chair/comfy/shuttle{
	dir = 8
	},
/turf/open/floor/pod/dark,
/area/ruin/unpowered)
"qr" = (
/obj/machinery/light/broken,
/turf/open/floor/pod/dark,
/area/ruin/unpowered)
"qH" = (
/turf/closed/wall/r_wall/syndicate/nodiagonal,
/area/ruin/unpowered)
"sV" = (
/obj/structure/closet/crate/secure/loot,
/turf/open/floor/plating/lavaland_baseturf,
/area/ruin/unpowered)
"us" = (
/turf/open/floor/plating/asteroid/basalt/lava_land_surface,
/area/lavaland/surface/outdoors/explored)
"uI" = (
/obj/effect/decal/cleanable/blood/drip,
/turf/open/floor/pod/dark,
/area/ruin/unpowered)
"vC" = (
/obj/machinery/computer,
/turf/open/floor/pod/dark,
/area/ruin/unpowered)
"wv" = (
/obj/structure/window/reinforced/spawner/north,
/obj/structure/shuttle/engine/heater,
/turf/open/floor/plating/lavaland_baseturf,
/area/ruin/unpowered)
"xA" = (
/obj/structure/lattice,
/obj/structure/window/reinforced/spawner/north,
/turf/open/floor/plating/asteroid/basalt/lava_land_surface,
/area/lavaland/surface/outdoors/explored)
"xO" = (
/obj/structure/window/plastitanium,
/obj/structure/grille,
/turf/open/floor/plating,
/area/ruin/unpowered)
"xY" = (
/turf/open/floor/pod/dark,
/area/lavaland/surface/outdoors/explored)
"zP" = (
/obj/structure/door_assembly/door_assembly_hatch,
/turf/open/floor/pod,
/area/ruin/unpowered)
"Aw" = (
/turf/open/floor/plating/lavaland_baseturf,
/area/ruin/unpowered)
"AQ" = (
/obj/structure/shuttle/engine/propulsion,
/turf/open/floor/plating/asteroid/basalt/lava_land_surface,
/area/lavaland/surface/outdoors/explored)
"BL" = (
/obj/structure/girder/reinforced,
/turf/open/floor/plating/lavaland_baseturf,
/area/lavaland/surface/outdoors/explored)
"Dv" = (
/turf/closed/mineral/volcanic/lava_land_surface,
/area/lavaland/surface/outdoors)
"EY" = (
/obj/structure/lattice,
/turf/open/floor/plating/asteroid/basalt/lava_land_surface,
/area/lavaland/surface/outdoors)
"Ib" = (
/obj/structure/chair/comfy/shuttle,
/turf/open/floor/pod,
/area/ruin/unpowered)
"IR" = (
/obj/machinery/light{
	dir = 8
	},
/turf/open/floor/plating/lavaland_baseturf,
/area/ruin/unpowered)
"Jg" = (
/obj/structure/closet/crate/secure/loot,
/turf/open/floor/plating/asteroid/basalt/lava_land_surface,
/area/lavaland/surface/outdoors/explored)
"Kf" = (
/turf/template_noop,
/area/template_noop)
"MB" = (
/obj/item/ammo_box/magazine/ak/m556,
/turf/open/floor/plating/asteroid/basalt/lava_land_surface,
/area/lavaland/surface/outdoors/explored)
"Na" = (
/obj/item/ammo_box/a762,
/turf/open/floor/pod/dark,
/area/ruin/unpowered)
"NP" = (
/obj/structure/girder/reinforced,
/turf/open/floor/plating/asteroid/basalt/lava_land_surface,
/area/ruin/unpowered)
"OF" = (
/turf/open/floor/pod/light,
/area/ruin/unpowered)
"PK" = (
/obj/structure/table_frame,
/turf/open/floor/plating/lavaland_baseturf,
/area/ruin/unpowered)
"Qp" = (
/turf/open/floor/plating/lavaland_baseturf,
/area/lavaland/surface/outdoors/explored)
"RN" = (
/turf/closed/mineral/volcanic/lava_land_surface,
/area/lavaland/surface/outdoors/explored)
"Sn" = (
/obj/effect/decal/cleanable/blood/gibs/limb,
/obj/effect/decal/cleanable/blood,
/turf/open/floor/pod/dark,
/area/ruin/unpowered)
"SM" = (
/obj/item/ammo_box/magazine/m10mm,
/turf/open/floor/plating/asteroid/basalt/lava_land_surface,
/area/lavaland/surface/outdoors/explored)
"Un" = (
/obj/machinery/computer{
	dir = 4
	},
/turf/open/floor/pod/dark,
/area/ruin/unpowered)
"Uv" = (
/obj/item/ammo_box/c10mm,
/turf/open/floor/pod/dark,
/area/lavaland/surface/outdoors/explored)
"UX" = (
/obj/structure/door_assembly/door_assembly_hatch,
/turf/open/floor/plating/lavaland_baseturf,
/area/lavaland/surface/outdoors/explored)
"UY" = (
/obj/item/gun/ballistic/rifle/soviet_sniper,
/turf/open/floor/pod/dark,
/area/ruin/unpowered)
"Wc" = (
/obj/structure/chair/comfy/shuttle{
	dir = 4
	},
/turf/open/floor/pod/dark,
/area/ruin/unpowered)
"WR" = (
/turf/open/floor/pod/light,
/area/lavaland/surface/outdoors/explored)
"XM" = (
/obj/machinery/light{
	dir = 4
	},
/turf/open/floor/pod,
/area/ruin/unpowered)
"YH" = (
/turf/open/floor/plating/asteroid/basalt/lava_land_surface,
/area/lavaland/surface/outdoors)
"Zn" = (
/obj/machinery/sleeper/syndie/fullupgrade{
	dir = 4
	},
/turf/open/floor/pod/light,
/area/ruin/unpowered)
"Zx" = (
/obj/item/ammo_box/a762,
/turf/open/floor/plating/asteroid/basalt/lava_land_surface,
/area/lavaland/surface/outdoors/explored)

(1,1,1) = {"
Kf
Kf
Kf
Kf
Kf
Kf
Kf
Kf
Dv
Dv
Dv
Dv
Dv
Dv
Dv
YH
YH
Dv
Dv
Dv
Dv
Dv
Dv
Dv
Dv
Dv
YH
YH
YH
Dv
Dv
Dv
"}
(2,1,1) = {"
Kf
Kf
Kf
Kf
Dv
Dv
Dv
Dv
Dv
Dv
Dv
YH
YH
YH
YH
YH
Dv
Dv
Dv
Dv
Dv
YH
YH
YH
YH
YH
YH
Dv
Dv
Dv
Dv
Dv
"}
(3,1,1) = {"
Kf
Kf
Kf
Kf
Dv
Dv
YH
YH
Dv
Dv
Dv
Dv
Dv
YH
YH
Dv
Dv
YH
Dv
Dv
YH
YH
YH
YH
YH
YH
YH
Dv
Dv
YH
YH
YH
"}
(4,1,1) = {"
Kf
Kf
Kf
Kf
Dv
Dv
YH
YH
YH
Dv
Dv
Dv
Dv
YH
YH
YH
YH
YH
Dv
YH
YH
fG
fG
fG
fG
fG
fG
qH
YH
YH
YH
YH
"}
(5,1,1) = {"
Kf
Kf
Kf
Kf
Dv
YH
YH
Dv
YH
YH
YH
YH
Dv
YH
YH
YH
YH
YH
Dv
YH
us
hA
hA
Zn
eK
Zn
wv
gW
YH
YH
YH
YH
"}
(6,1,1) = {"
Kf
Kf
Kf
Kf
Dv
Dv
YH
YH
YH
fG
fG
fG
fG
fG
NP
YH
YH
YH
YH
YH
hA
eS
us
hA
us
OF
wv
gW
YH
YH
YH
YH
"}
(7,1,1) = {"
Kf
Kf
Kf
Kf
Dv
Dv
Dv
YH
fG
fG
Un
fG
iR
IR
Aw
iR
Aw
hA
us
RN
us
ic
WR
Qp
us
us
wv
YH
YH
Dv
YH
YH
"}
(8,1,1) = {"
Kf
Kf
Kf
Kf
Dv
Dv
Dv
YH
xO
eD
pa
fG
iR
Ib
iR
Ib
iR
Qp
hA
us
hA
ic
ic
BL
hA
Qp
xA
us
us
YH
YH
YH
"}
(9,1,1) = {"
Kf
Kf
Kf
Kf
Dv
Dv
YH
YH
xO
vC
aw
fG
iR
io
io
iR
Aw
us
us
us
us
YH
YH
YH
YH
us
us
us
AQ
YH
YH
YH
"}
(10,1,1) = {"
Kf
Kf
Kf
Kf
Dv
Dv
YH
YH
EY
kC
uI
zP
iR
io
gn
us
us
us
us
hA
us
YH
YH
Dv
YH
YH
YH
YH
YH
YH
YH
YH
"}
(11,1,1) = {"
Kf
Kf
Kf
Kf
Dv
Dv
YH
YH
YH
iB
mG
fG
iR
io
iR
PK
us
us
us
hA
us
YH
YH
YH
YH
YH
YH
YH
YH
YH
YH
YH
"}
(12,1,1) = {"
Kf
Kf
Kf
Kf
Dv
Dv
YH
YH
xO
Sn
Wc
fG
Aw
Ib
iR
Ib
Aw
us
us
us
us
YH
YH
YH
YH
YH
YH
YH
YH
YH
YH
YH
"}
(13,1,1) = {"
Kf
Kf
Kf
Kf
Dv
Dv
YH
YH
fG
fG
mo
fG
iR
XM
Aw
dL
Aw
hA
us
us
us
YH
YH
YH
YH
YH
YH
YH
YH
YH
YH
YH
"}
(14,1,1) = {"
Kf
Kf
Kf
Kf
Dv
Dv
YH
YH
YH
fG
fG
fG
fG
fG
fG
fG
YH
YH
YH
YH
YH
YH
YH
YH
YH
YH
YH
YH
YH
YH
YH
YH
"}
(15,1,1) = {"
Kf
Kf
Kf
Kf
Dv
Dv
YH
YH
YH
YH
YH
YH
Dv
YH
YH
YH
YH
YH
YH
YH
YH
YH
YH
YH
YH
YH
YH
YH
YH
YH
YH
YH
"}
(16,1,1) = {"
Kf
Kf
Kf
Kf
Dv
Dv
Dv
YH
Dv
Dv
Dv
YH
YH
YH
YH
YH
YH
YH
YH
YH
YH
YH
YH
YH
YH
YH
YH
YH
YH
YH
Dv
Dv
"}
(17,1,1) = {"
Kf
Kf
Kf
Kf
Dv
Dv
Dv
Dv
Dv
Dv
Dv
YH
YH
YH
YH
YH
YH
YH
YH
YH
YH
YH
YH
YH
YH
YH
YH
YH
YH
YH
Dv
Dv
"}
(18,1,1) = {"
Kf
Kf
Kf
Kf
Dv
Dv
Dv
Dv
Dv
Dv
Dv
YH
YH
YH
YH
YH
YH
YH
YH
YH
YH
YH
YH
Dv
Dv
Dv
Dv
Dv
Dv
Dv
Dv
Dv
"}
(19,1,1) = {"
Kf
Kf
Kf
Kf
Dv
Dv
Dv
Dv
Dv
Dv
Dv
Dv
Dv
Dv
Dv
Dv
YH
YH
YH
YH
YH
YH
YH
Dv
Dv
Dv
Dv
Dv
Dv
Dv
YH
YH
"}
(20,1,1) = {"
Kf
Kf
Kf
Kf
Kf
Kf
Kf
Kf
Kf
Dv
Dv
Dv
Dv
Dv
Dv
Dv
YH
YH
Dv
Dv
Dv
Dv
Dv
Dv
Dv
Dv
Dv
Dv
Dv
Dv
YH
YH
"}
(21,1,1) = {"
Kf
Kf
Kf
Kf
Kf
Kf
Kf
Kf
Kf
Kf
Kf
Kf
Dv
Dv
Dv
Dv
Dv
Dv
Dv
Dv
Dv
Dv
Dv
Dv
Dv
Dv
YH
YH
YH
YH
YH
YH
"}
(22,1,1) = {"
Kf
Kf
Kf
Kf
Kf
Kf
Kf
Kf
Kf
Kf
Kf
Kf
Kf
Kf
Kf
Kf
Kf
Kf
Kf
Kf
Kf
Kf
Dv
Dv
MB
ic
Qp
us
qH
qH
qH
YH
"}
(23,1,1) = {"
Kf
Kf
Kf
Kf
Kf
Kf
Kf
Kf
Kf
Kf
Kf
Kf
Kf
Kf
Kf
Kf
Kf
Kf
Kf
Kf
Kf
Kf
Dv
YH
us
ic
Uv
hA
Na
qr
qH
Dv
"}
(24,1,1) = {"
Kf
Kf
Kf
Kf
Kf
Kf
Kf
Kf
Kf
Kf
Kf
Kf
Kf
Kf
Kf
Kf
Kf
Kf
Kf
Kf
Kf
Kf
Dv
YH
us
us
hA
us
eD
UY
Aw
Dv
"}
(25,1,1) = {"
Kf
Kf
Kf
Kf
Kf
Kf
Kf
Kf
Kf
Kf
Kf
Kf
Kf
Kf
Kf
Kf
Kf
Kf
Kf
Kf
Kf
Kf
Dv
Dv
Dv
gf
UX
us
sV
eD
hA
YH
"}
(26,1,1) = {"
Kf
Kf
Kf
Kf
Kf
Kf
Kf
Kf
Kf
Kf
Kf
Kf
Kf
Kf
Kf
Kf
Kf
Kf
Kf
Kf
Kf
Kf
Dv
Dv
Dv
hA
Qp
us
hA
Aw
us
YH
"}
(27,1,1) = {"
Kf
Kf
Kf
Kf
Kf
Kf
Kf
Kf
Kf
Kf
Kf
Kf
Kf
Kf
Kf
Kf
Kf
Kf
Kf
Kf
Kf
Kf
Dv
Dv
Dv
us
ic
Jg
us
us
us
hA
"}
(28,1,1) = {"
Kf
Kf
Kf
Kf
Kf
Kf
Kf
Kf
Kf
Kf
Kf
Kf
Kf
Kf
Kf
Kf
Kf
Kf
Kf
Kf
Kf
Kf
Dv
Dv
Dv
us
ic
hA
xY
Zx
us
hA
"}
(29,1,1) = {"
Kf
Kf
Kf
Kf
Kf
Kf
Kf
Kf
Kf
Kf
Kf
Kf
Kf
Kf
Kf
Kf
Kf
Kf
Kf
Kf
Kf
Kf
Dv
Dv
Dv
us
SM
us
xY
hA
us
us
"}
(30,1,1) = {"
Kf
Kf
Kf
Kf
Kf
Kf
Kf
Kf
Kf
Kf
Kf
Kf
Kf
Kf
Kf
Kf
Kf
Kf
Kf
Kf
Kf
Kf
Dv
Dv
Dv
Dv
YH
YH
YH
YH
Dv
YH
"}
(31,1,1) = {"
Kf
Kf
Kf
Kf
Kf
Kf
Kf
Kf
Kf
Kf
Kf
Kf
Kf
Kf
Kf
Kf
Kf
Kf
Kf
Kf
Kf
Kf
Dv
Dv
Dv
Dv
Dv
Dv
YH
YH
YH
YH
"}
(32,1,1) = {"
Kf
Kf
Kf
Kf
Kf
Kf
Kf
Kf
Kf
Kf
Kf
Kf
Kf
Kf
Kf
Kf
Kf
Kf
Kf
Kf
Kf
Kf
Dv
Dv
Dv
Dv
Dv
Dv
Dv
Dv
Dv
Dv
"}
